>Rosalind_3816
GTTTGAGTACGGCATCTCGAGCTCTTCACCGTCACCTCCGCGCAAGGGAGGCCACTCACG
TTGGGTGTATTAGATTTGTGTAGATATGCGATTAAGGATTTGTACCCCCAAGACGCCATC
TTCTATGACCCTCACGGTTGTCGGGGGTGGGATGGCTTTCACCGTGCTACATTCTCTACG
TAAAAGTATGATAATTTTAATGTGGCTTGTTTCTGTCATGTCCTTGGTGATGATCCGTGT
AGAGGGGAAGCAAGACTCCTAGGGACGAACAATATAACATCTATGCCTCCTGGGCTAAGT
TGCAGCTCATGTTCATTATTAGAAGGCGTCGACTCGGCATTTCTAGTTTAGGCTCTTCGT
CAGGTGTGCAGGGACTAACAGTCGAGCTGATGGATATCGATAATAAAGTAAGGTAGTACA
ATGTAACTACGCTATCGGGGATGAAACTCATCGATAGATTTATAGAAGTAGTGATGATAG
TGGATGTGTATCAGAACATAATATAGTAGACACAGGGACACTAACACGACATACTCCGAA
CGGATGGTGTTAATGGTCTACCATCTGCTATAAAAGCCGCTCAAAACGAGCTGATCGACG
TCGCATAAACGCTGGTGAGCCCCCGGCGCAAGTACAGAGTCCTCAGTCGTGGACATTCAC
CCGCGAAATCTGACTCGCCAGAATGTGCATAGAAAGCGGGTAGTTGCGCGTCGTGTCGGC
GAGAAACCAGTACGTTCACATTCTATATATTCCGTAAGGTGTATTTGGAGCTCATCATGG
GTTGACCAAATCGATTGAATCCTTGCCGTGAGGAACCTTGGGCCTGGCTATTGATCACCA
GCATGAAATCCACCAACAGTGCCTTCCGTCCCACAATAGTAAACCATACCCGATGGCAGA
ATCAAGAGTTGTTGGGACGTCAC
>Rosalind_3215
GACCCGGGAGATTACGTTGCTCGAACACGTTTTAAGGGCGATTCACCTTTCCGGGGTTCA
AGTCGAATGTGGGCTGGCAGGACGTAAGGAACCGCCTGTTCCTAATGATTTGCTAGAGGA
CCCAATTGAAGCAGGGGTTGGCGGTTGGTTCCATCGAATTGATAGTCCAAGTGGATGACC
GGCCCCTTATCACGCTGGCAGAAGGGTGGTACGCCACTCGAGTGAGCCCGCGCGCAAACG
AGGACCGGCAAGGATAGGACCTTAGGGCTGTTCTGATAATCGTACTTTGCTAGACAACGG
AACCTCCTCTCCATCTCCCTGGGAATTTAGGGAATACTCTGTGAGAAACTTGATTGCGAA
CTGCAGAGCAGCGAAGTCTCTAGTTGACAATACACCGATAGTTTGGTGCCCGCGCTGACA
TTATACCGTCGACCATACGCCCCCGGCGCGCTCGCTCGCCACAGACCCTATTACCGCATA
TACGTGGGTTGGACAGCTTCTCAGTTACGTAATCCTAATTGCACGCACGGATAATAAAAA
GAATACGGCCTTTCCCCAGAGTTCGCAATACAGATTCGACGTGTTTTTTTGCGTACTCAC
ATCGGCACTACTATCGTCGGCAAAGGGCGTTGGTTCCTTCCCGTGGTTGGACCCAGGCCA
CTCGTAGGGGGAGATAACGGCTGCCTTGCAGTAGGGAGCCGGCGTGGAACTTGCATGAAT
GCGTGTCGCGGGGTTCTCGAAGTCTCGTAGCAGTAGTAATGGAATGAAGTGTGGACGTCC
TACTTGTTAGGTGGCCGTGGACATTTGGGAAAAAAACGTAATACTTGCAATCTGCCTCTC
ATGCAACATGGAGCCGGGCCGTTGACCCGTCCTGACAATAATACCAATCGCACACCAGGA
CTGTACGCCCAATTCTTTTCAAC
>Rosalind_3606
GTTACAGCTGACACTAAGATTACATCCTAGAGAATAAATTAAGTGAGTGGATAGGGCAAC
AGACGGGCGTTGAAAGTCTTGGAGTCTGGTCTAGGGAGTCTGCTCAAATGCACTGGCTCT
CCTAGCTGGTAGATCACAGCCCGCTTCTGGGCCATCAGTAGAATCAGGACTCGTTGGCCT
TCAAGGCAGATCCGTATATTCGGATCCAGGTGGGCGTATAAGGCCGGTGCACTGGCGAGG
AATGTAAAGCAGCATCACACTCTAGATCGAACCACTTACTATCGAGGCCATCCCTTGAAG
GCGATTATTCGATTAAGGCCAGTCGAGTTAGATTGCCACATCTAATAACCGTGGGCGCCA
TCAACCGGTGACCCCGGCCTTACGACAAACTCATTCTCGGCTCGAAAAACTCTCCTTCCG
AACGTTCATCCCTCCGCAAGTTTGGCCGTAGTTGGGGTTGTAGTCATCCGCTTCGCGAAG
CTGTATTGTCTGATGCATGCACAACAATTGTCGTGACATCCCTGATATGCTCAGCTATAG
TGTAGTTCTGCTCAAGGACCGCGTTTACCCGCTTCTTGGGGTATATTTCGGGCCGCGCGC
GCAGAAGGTCCCCACCACAAAACTGGAACGCGAAGTAGCGCGCAGTCCGTAGTATGCCCA
ATTACCCCCCAGTAGAAACACGGTACCCTGCTATACTCACCTCTAAAGTTCTTACCCGTG
GCCGTAAACATGTCTCCCACGCCGACAAATCCCTCAGCGAAGCTAGTTTCATTGCGGAAT
CACTTAACTGATACATTTTTTCTCCTAGAGGCGGCCGTGTCTACTGGTTTCTAAGATAAG
GCCCTGGCAATTGTATTTCCTCACCGGTCGTATGGGATCAATATTTCGCCAGCGGTGCTG
GTCACTAGCGCACTTCTAGCGTT
>Rosalind_4236
TAAGCGCGGTTATACGCTACAGCTTCAGTCCCGTCAGCATAAGAGACGTGGCGGAATTTC
CTTCATCGGCGAGTTAAATTTCGCTTGGAAATTGGAAAAACAGATTCATTGGGAATATTA
ATGGGATACGTAAGGCATCATCAGTTAAAAAACAAAGGTAGCAGATATTTAACCTTTCGT
CCATAACACAACTTCAGTATACATGATCTAGGGGCATCGAAATATGTCGGATTTTCCAAA
CCGGCAGAGACCTTCGTCAAATATTGTGCAAGATATTAAGCAGCAAGTCCAGTGCTGCCT
TATCTGGTTCCACAAGTTGGCAAGATTAAAGTTGCTCTATTGCCAAGGGCCTCAATGTTC
TCCAATACGACTAAGCACGAAGGAGGCTAGGATCTAATTTCAGACAATATTTAATCGGTG
TAGCGCCGTTCCGGGATCCTGACACCTGTACTAATACGGCGACGGTGTAATGTCTGGGAT
TAGAAGGGGTGCTCGCCCATCGGACGTAGATGCGGACCGCCACGTGGTGATGACTGGCCA
GACCGCATGGTATCGAACGGTCTCACCGAATCACTCAAGAAGAGATGTTCACAGTCTCCT
ACCGCAGAGTTGGTGGGGTGGGATGTCACGGCGAGGCTGTACAAGCGGCATTTCGCTGTC
CCTAGTCTACGATCCGTGACACAGTGAAGGTGACTCCGTAGCGTTCGATAGACCTCGTAC
ATTATCCAGCTCCCGCCCCTAATAGAACAGTCGCATATACTATTTTGATTAATCCTGAAC
TAATTCAGGCTTCAAGTAGTAAAAAATGGGGCGCGAGAGAAAGGATGCATGAGCTTATGG
ACTGATAAACGGCTACTAAACTTCTAACGCTTCCATAACGGCAAACGGGGTAGGGCCGAA
TCTACTTGTGAGGCCGTCGGTGA
>Rosalind_1544
TCCGGTACCCGTCTGTTGTCGGTCGCTCAGTAAACTGGGTGCTCCCAGTGGGTGTCCGTT
GCTATCTGTCGAACCGCAAAACCGTATAGCATCCATAGGTTGGAAAGTGATAGAGGGTGA
ACCGATGTGCGAAGCGTGGGACTCAACTTCGTACATCATAAACTTCACAAGAAACTTGTC
TAATTAAATTAATACGAGGTTGAAGTCAATGTATAAGTCATACGTTGCATTAACGCGTTC
CGCATATTGAGGCAAGCGCGTATGATGAATTTGCTTCAGACGCCGACCGTCAATTATAGC
TGGCACCGGTGGTGGTCTTGGGAAGAGGTGTTCGAATTGGGTCCGTAAATCGCCCTGGAA
CTGTAGCTATTGGACGAGGCCAGATCGCTCCCCGTCGCCGTTTCTGGCCTTCCGACTAGA
AAAATACCACCTTGATGAAATAGAGCAAACAAGTTCACAAGGATGTAGAGTCCTAAGCAA
CCCGGCTGGAGACCGTAACTGACTAGAACGGGCGTAGTTGCTATGAGCGACCAGATGTTT
CAGGAATAAATCGGCGTGCGGACGGTTCGGAACGCTCGTGGGTTGCTTCGCGCCTACCTG
TACCGTAGAATATAGGCGCCGCCGTTCAGGAACCATTGCGTTTGAATCTTACAGAGTCAA
GACCCGGCAGCAGCGACAATATGATGTTGAGCCGGGCCGTAGTCACCTATACAATGTTGA
AGTGCACGAACAGGGACATCTCCTGATAGGCGGTTCACTGCCTAGATACCGCGGCCGCTT
CCGTCATAACTGGCTCGCGTGCACTGAGTCTATTGTTATTCCTGCCAAGCCTAAGGTGAA
TGTGACGGCGATGTACTACGTTCCCCGCAGAGCGGCGTTCTCGTGCGATTCCGCTGTCGA
AACATACAAATATATTTGCAAAT
>Rosalind_1596
GTAGCGTGTCCAGGGTGCGCGCAAATTGTCTGGTGGTCAATTGGACTCACACCGAACTGA
CTAATCATTCCTGTTTTAGTCTGGAGAACGACTAATGCACTAAATTACCAGGTTACTAGC
ACGTTACAGCACTACTGTCAAAACCGCTCGTAAGGGTAACCTAGGATATAATGAAGAGGC
CAGATGCAGGACGCCTGAGAATTACTGTGTAAATCCTTAAGTAATCCAAAATAACCAATC
CACCACGTTCGAGGGTGCGCGTATGACGATGTACGTGCCTCCCTCGGTAGGTTAATGTGC
CGACGCAAGGCCTTAATGAGCAAAAATGCGTTACTGTGCTTGCCACCGTTACATGCGAGC
GACGATGTGCCGTGAGGCTCCACTATATCTCTGGAACTCGTATTGAAAGGTGGAACTACA
TCGTAATAACAGGACAACATCTGGAATAACAAATTGCGGGGTTCCGCTAGGGACGTTTCA
CTGTTTTTATCTACCCAACGCGCGGCGTATCATCTCGGTACGTCGCGGCAAGGGTGTTAG
TCTAGTGACACCCTTGTGTCCTGACCCGAGTATATACCACGGAAAGCACCGGGTACTGCG
TTGATAAATTGGGGGACTTACAGTTGGCTGCCGTGAGCAGTAATACATGCGGCGAGAGTC
TGAGAGCTCCGGTTTTTATTCATTAAAGTAAGTGTAATCGACATGAGCACCCTGTCACCC
TGGAGCGAGGGATATCTTGCTGGTTGAGGACTCCCGGGTTTCCGTGACGGCGTAAGCAAT
ATCTTCCCCTGACATACCCACTTTTACCCACGCAGTCAATTAAAGCACCCAAGACCGGGT
GGTACTGTGACGAATAGGGACAAGATGAGTCCGCGCAATGTTGTCCTTATTACCAAGTGT
TTCGTTTCTTCTTGGACGCCCCC
>Rosalind_6915
ACTAAGCGCGGGGAGTGGTGTGCATGAATTGCCATTCATTTCCCACGGGCAAGAACACAC
CTGCTGCTTTCGTGCCCCGCACGTTCGGTACATGTGTTGAAATTTTATCGTGTTCTCTAA
CTCCTGACCAATGCTTCGTAGAGGGAACCCCTGCGAGAAGAGAGAATCATGCTTAGTGAG
TATGATAAACCTTCCAAACAGTTATGAGTTGACCCCCGACCTAAGTCTCTAACTGCTATG
AATAAAGTGCAAGGGTCTCAATGCGCAAGCGAGGTTTTGACCCTAGCCAGAGTATACGAC
GCGGTTGCAATGCAAGAAGACTCCAAGCAGCGTCCGGCTTGTTACCGCGATGCTAGGGCC
GAAGCGTCTGGTAGGTATATGTGATCACTTTGACGCCCGCCCTGGTGCCCCACGTTGTCA
ATGAACCTGGGGGCTGTTGAACAAGTAAGGTACACGGCGGCCGCACCATCCCGCGGCAGG
TTGTTCAAATATATAAAGCCTTACACATCTGCGGAGTAGTAGGTGTCAAAGTCAGCTCTA
AAGCGATGGATGCGGGCACCATGCTTGACACTAAGTCCACATCTCCATCAAGGTTTCGCT
AACTCAGAGACGCAGTGTGCGGAATGGCGAGACTTGATCATAGTGCCCAAGTCCTGACTA
AGACTAGGGTTTTCCTTCAGTGAGACCAACCACACCGATCCACTTCAAAACCCAAAATCG
AGAGTTGAAGCTGGGTCGGGGATCCTTTCACTAACGGCCACTACACACAGGCTCCAACTG
CTAGCGGATCCCACGTAGGGGTTCACACATGTCAGATATAGGAACCCACCAACATTTCGA
GCCGATTATCACATCGAAGGTGAGATAGAACCCGGTAGTTTAGTCATGGACGTGGATTTT
GAAACCCGTGAGCTGCTAACGGT
>Rosalind_5603
CCGCCTCTGACAGCTTAAAGCCGGCCGACCTACTGAATGGGCGTCAAAACGTCCGAGTTT
CCACTCAATGGTCCCCGCTTTAGCTGATGTCGGGGTGATGTGGGGAAATCTTTGACATGT
ACACTATGGACAATCGTAAGGTCAATAAGGGGTAAAGGTGTGGTAGATTTGGTATATGTC
ATAATCTTCGTAGAACCCGAAACTGAAAAGCAATGTTATTTGGTTACTCAATTAAACCAT
TTCACACAAGTGATAATATCGTGCGGTGTCAAGTGCGGATTAGATGTAATTGCACCAAAG
AGTGTGCGTCACCGTTGAGTTGAGTCTTTCGACCTCGCGACACCTTGTGGATTGGCACGA
TAGCGGATCACGCTGGAGATCCCTTCCCTAGGTGTGTGACACTAAGTTTGGACACATCGC
ATGTTGAACGAAAGCGAGAGTGACACTAGGCTTACGTGCATCCGAACCGAGTTAGTGAGC
GAACCAGGTTTATATAGTTTGCCTAACGGCTGAGGGCAGGCGAAGGGTGATTGTGTGAAT
TATGTTAACAGGAGACTAGGAGGCTTCATAATCCCGCGATTGCAGGGAAGGAGACGAGTC
GAAAAGCCCTGAGATGCGCGTTCTAACGCTCTATAGCTTATCTGCACTGTCCGCGGGGTA
ATCTTAAAAAATACTAGCCTCGTGCCGTCCCGAATACTGAATGACCGACATTCGTATCAC
AGAGCGAAAAACTGCGCCAGCAATAGTTACCCCCGCAAATTGCACATGTGGACCTGTACA
GTTGGTATCTAGTTTCTTTACCGGCAATCCGACTAAACAACGTCGGCAAACCCATTTTAA
GTATCTTTCAATAGACGCAGGTTCAGGCGGCGCGCTTATTGTAGGATCCACATGCCCAGT
ATCGTACAGTACCGTGCTTACGT
>Rosalind_1307
TTATACACCCTCCGCCCGAATCGCTGGGCCCATTGCATTTAGTAGTTCCTTTACCTGTGA
TGAAGACAGAAGGTATCACTTCAAGGCGCTTGAGTCGTGGGTCACACCCTGCGGAGGGGT
GTGCGGAGATTAAATATTCGCCACTGAGGGTGTACATAGAGTCGTCTTCCCGATGATTTG
CATAATGGAGCCCTGGAAATTCACATCTTCTAAAACGTTACGGAGAATCTTGGCATAGAT
CATAAGATCTCCACCCGGCGATGAGATGCACTTCTGAAAGCTGCCGGTAGCCCGTATGGA
AACGCCATTTTGTCCTAGGTGACTCCGGAGTGGGTGTCTAGCGTACAATAGGCAGGTTTT
TATAAGCAGGTCGTTGATATAGCTATACCAGGTTTCTAGCCAGCATCACAGAGTAAAGGG
AACAACAACCCGGAATACTGAGCTCTCAACGGTCATACATAAACGCGTAACGTTGAGTAA
TCATCGTTGAAATTATGAACTGACACTGTACTATAATACCCCGAACAGGTTCGGCTGGAT
ACAGTCACAGCCCGCGCTCTCGAATGGTCCTTGCCATTAAGACAGACGGGAGTTCAGCAG
GTAATCGCTATTCTGCCTTAAATATGGCAAAATACCTTGTAGCTGCGGTTGTCTCCCTCC
TTAACACATCTCAATCCAGACTCGCATCGGAGTTCGTGTGAAAGCCCGACGTTAGTGGTA
TGAAAATGTGCATATCAGTTTAACCGGGCCTCTCCACCCTCTGGACTCTCCTTTGATCGA
GGCTGAATACTTTGGCTGAGGGGGTTCCGCACTCCGGAACCAACGTCCAGATAAGTTCTA
AGCAGTGGGTAAGACAGTCCTACGAAAAGTCGAGGGTTTCGGCGTCATAACCGATCCAGC
TTAATACTACCCGTCGAAATATA
>Rosalind_2953
GCCAAGAGGGTGCGTAGCGCGGATTCATGCGGCGCGAAAAGCTAGTTGAGTCTCTAGGGA
CCTTAAGGAGGGGTCCCCTGGCTTGCTAGCGAAGTAACTCATTTATAAAGTGCCCGTACC
CACTCTGACCGTTAAGTTTCACACTTGTGTCGTGGTAGCGTTAGACGATTTATGCATATA
GGTTCCTGTAGGTATTGTTTACCACGCCAGAGCCGTTAATCACACAGGCTCCTTTGCTAT
TAGGATTAATCTTCCCTAGAATAAAAACGCACGACTGGAACATTGTCCGCACAGACACGA
ATTGCCACAGGAGTATCTAGTATTGAATCACGCCTTTTGTCGGAGGACTTATTTTTGGAG
CGATCTCTGCTGATTTACAACTTCTTATCATTTGGATGAATTTACAGCGATATTCGTTCT
GGCTCGTTGGATACGTTCGCTGATACGGTAACGATGCTGTCAAACCCATCTCCTAGAAGA
TCGTTCGCATTGGAGAGGCACCGCGTAGAATTAGTTCGAGTGCCCTACTACGCTTCAGCG
TTAGACAAGGAAGGCCCCCGCAAGGGGTTGCGCACTTGAGGCAGAGCCCTACTATGCACG
CCCTGTTCAGTTAGTTGGGCTAAGCACGACCATACGGTCGCTCGCCGCTCCATGCGGTCC
GTAGATGATGAAGCGTCAGATCCAGACCGTATCAAATCAACTCGGGATGACACTGGCTGG
CTATCGCACGATCTCCGCGGATAGGGACCGCCTCTGTCGGTGAGCAAGCAGAGATACTCG
TCTTAGCCTGGCATTCCAATAGCCCCATCGTTATTTTCTGCTGGAGAGCCGACACTTGCA
ATGTTGCTTCAGCCACAAAGGTTCTGGCTCTGGTCCGTAATATGTTCCTCGCATTCGAAC
TTGACCACCACCTGCGTAAGTGA
